type octile
height 14
width 13
map
TTTTTTTTTTTTT
TTTTTTTTTT...
T............
T............
T....TTT.....
.....TTT.....
.....TTT.....
.....TTT.....
.............
.............
.............
.............
T...........T
TTTTTTTTTTTTT
